111111111111111
100010010000101
10000C010010101
100010010C10001
111111011111011
10P010010010001
10000C010010001
111011011000101
100000010010101
111101111110111
100000000010101
100000010000101
111110111010101
10CC0E100100011
111111111111111
