11111111111111111111111111111111111111
100000000000000C00000C0000000000000001
10100101001000001010010000000101000001
10100100101010100010010000000101000001
1P0000000C00C0000000000000000000C00001
10000000000000000000000000000000000001
1E0000000000000C00000C0000000000000001
10100101001000001010010000000101000001
10100100101010100010010000000101000001
100000000C00C0000000000000000000C00001
10000000000000000000000000000000000001
100000000000000C00000C0000000000000001
10100101001000001010010000000101000001
10100100101010100010010000000101000001
100000000C00C0000000000000000000C00001
10000000000000000000000000000000000001
100000000000000C00000C0000000000000001
10100101001000001010010000000101000001
10100100101010100010010000000101000001
100000000C00C0000000000000000000C00001
11111111111111111111111111111111111111