1111111111111111
1000P00100000001
1C111111101111C1
1ECCC00P00010011
1111111111111111
