1111111111111111111111111111111111
10000001E0000000000000000000000001
1010010111000000101001000000010101
1111010010101010010101000000010101
100000000000C0001PC010000000000001
1111111111111111111111111111111111